0 0 0 0 0 0 0 0 0 0 0 0 0 0 0 0 0 0 0 0 0 0 0 0
0 0 0 0 0 0 0 0 0 0 0 0 0 0 0 0 0 0 0 0 0 0 0 0
88 0 0 0 0 0 0 0 0 0 0 0 0 0 0 0 0 0 0 0 0 0 0 0
9201 0 0 0 0 0 0 0 0 0 0 0 0 0 0 0 0 0 0 0 0 0 0 0
9201 0 0 0 0 0 0 0 0 0 0 0 0 0 0 0 0 0 0 0 0 0 0 0
9211 0 0 0 0 0 0 0 0 0 90 0 0 0 0 0 0 0 0 0 0 0 0 0
9210 0 0 0 0 0 0 0 0 0 90 0 0 0 0 0 0 0 0 0 0 0 0 83
917 16 11 13 15 11 16 17 12 75 0 0 0 0 0 0 0 0 0 0 0 0 0 9201
9212 0 0 0 0 0 0 0 0 9202 0 0 0 0 0 0 0 0 0 0 0 0 0 9201
9211 0 0 0 0 0 0 0 0 9204 90 90 90 90 90 90 90 90 90 90 90 90 90 9201
9201 0 0 0 0 0 0 0 0 0 0 0 0 0 71 0 0 0 0 0 0 0 0 9201
9201 0 0 0 0 0 0 0 0 0 0 0 0 0 917 0 0 0 0 0 0 0 0 9201
9201 0 0 0 0 0 0 0 0 0 0 0 0 0 913 0 0 0 0 0 0 0 0 9201
9201 0 0 0 0 0 0 0 0 88 0 0 0 0 916 0 0 0 0 0 0 0 0 9210
9210 0 0 0 0 0 0 0 0 9200 11 14 15 11 15 15 11 15 11 16 17 14 15 11
916 17 16 14 17 16 13 16 17 916 0 0 0 0 0 0 0 0 0 0 0 0 0 0
0 0 0 0 0 0 0 0 0 0 0 0 0 0 0 0 0 0 0 0 0 0 0 0