0    0  0  0    0  0  0  0  0  0  0  0  0  0  0  0  0  0    0  0  0  0  0
83   0  0  0    0  0  0  0  0  0  0  0  0  0  0  0  0  0    0  0  0  0  0
9201 0  0  0    0  0  0  0  0  0  0  0  0  0  0  0  0  0    0  0  0  0  0
9201 0  0  0    0  0  0  0  0  0  0  0  0  0  0  0  0  0    0  0  0  0  88
9211 0  0  0    0  0  0  0  0  0  0  0  0  0  0  0  0  0    0  0  0  0  9211
9201 0  0  0    0  0  0  0  0  0  0  0  0  90 0  0  0  0    0  0  0  0  9201
9210 34 46 30   0  -2 90 0  0  0  0  0  0  90 -1 0  0  0    0  0  34 0  9210
15   11 16 11   15 70 0  0  0  0  0  0  0  0  70 15 10 15   10 16 11 16 10
0    0  0  9212 0  0  0  0  90 -1 0  -2 90 0  0  0  0  0    0  0  0  0  9212
0    0  0  9211 0  0  0  0  0  72 15 73 0  0  0  0  0  0    0  35 47 34 9201
0    0  0  9201 90 -4 0  -2 90 0  0  0  0  0  0  0  0  70   15 11 16 11 9200
0    0  0  9201 0  72 15 73 0  0  0  0  0  0  0  0  0  9202 0  0  0  0  9202
0    0  0  9201 0  0  0  0  0  0  0  0  0  0  0  0  0  9201 0  0  0  0  9211
0    0  0  9210 35 36 33 47 30 34 -3 0  30 0  0  0  0  9210 48 30 0  0  9200
0    0  0  15   10 16 17 16 11 15 10 15 11 15 10 15 10 15   11 15 10 15 10
0    0  0  0    0  0  0  0  0  0  0  0  0  0  0  0  0  0    0  0  0  0  0