0 0 0 0 0 0 0 0 0 0 0 0 0 0 0 0 0 0 0 0 0 0 0 0
0 0 0 0 0 0 0 0 0 0 0 0 0 0 0 0 0 0 0 0 0 0 0 0
87 0 0 0 0 0 0 0 0 0 0 0 0 0 0 0 0 0 0 0 0 0 0 88
9201 0 0 0 0 0 0 0 0 0 0 0 0 0 0 0 0 0 0 0 0 0 0 9201
9201 0 0 0 0 0 0 0 0 0 0 0 0 0 0 0 0 0 0 0 0 0 0 9201
9201 0 0 0 0 0 0 0 0 0 0 0 0 0 0 0 0 0 0 0 0 0 0 9201
9210 35 31 34 0 0 0 0 0 0 0 0 0 0 0 0 0 0 0 0 33 0 31 9200
915 15 16 75 0 0 0 0 0 0 0 0 0 0 0 0 0 0 0 0 71 15 14 915
915 0 0 0 0 0 0 0 0 0 0 0 0 0 0 0 0 0 0 0 0 0 0 915
915 36 0 33 36 36 33 36 35 32 33 30 30 35 33 36 35 36 33 32 35 36 0 916
14 15 15 14 11 15 15 14 15 15 14 15 11 15 15 15 14 15 15 15 15 15 17 15
0 0 0 0 0 0 0 0 9212 0 0 0 0 0 0 9212 0 0 0 0 0 0 0 0
0 0 0 0 0 0 0 0 9204 0 0 0 0 0 0 9201 0 0 0 0 0 0 0 0
0 0 0 0 0 0 0 0 0 0 0 0 0 0 0 9201 0 0 0 0 0 0 0 0
0 0 0 0 0 0 0 0 0 0 0 0 0 0 0 9204 0 0 0 0 0 0 0 0
0 0 0 0 0 0 0 0 0 0 0 0 0 0 0 0 0 0 0 0 0 0 0 0